1111111111111111111111111111111111111111111111111111111111111111111111111111111111111111111111111111
100101001010100100000010101000100000001000000000001001000100000001010000000000010100100001E100010001
1000010000101001000100001010001000100010010001001000010000000100010000010100010101001010000000000001
1110000110101100000110101010111111110111111111111111010111101111000111110100010101000000010100010001
1000010010001001110100101000001000100010010100101001010001000100010100010111110101111101111111110111
1001011110111001000100100010001000000010000100000001011111110111011100010100000101000100100100000101
1001010000001011111110111111100011111010010101111000010010100100000100000110111101000000100100100101
1101110010001001001000001010001000000010111100101011110010000110111110111100100101110100110100100001
1001010111101001001001000000001111011110010100001000010000100100010100000100100101000101100110111111
1000010010001001001000001000001001001010000001101110110111110100000111101100000101000000110100100001
1101111111011011100011111101111000000010010100101000010000000100010100000100100001111011100100101001
1000000000001001001000100000001111011000110111111111111111011111111111101111111111000000000110101011
1111101111111101001000100100101001001010010001001010010000010010000100000000010001001000100100001001
1000000000001001001100000110111001001010010001000010010001010000010100000100010001111110111111111111
1011111111111001101000000100001100011010000001110110010001000010010100010100010001000000000100010001
1000100100101011001111011100101001001011111100000000011101111111111111110110000101001000000100010001
1000100100001001001000000100101011111010010001000010010000001000000100000100010001111101110001000001
1011110101111101011000100110111000000010010101111110110001000010010111110111111111000101000100011011
1000000100101001001000100100001000101010000101000000011111101011110100010100010001000001111110110001
1101111100101111011111111111111111111111111111111111110010101010010100010100010001111101000000010001
1000100100001001000001000000100000100100100010100101010010001010010110110101000001000001000100010001
1000100101111001000100001010000100000100100000100101010000101010000100000100011011101111111111111111
1101100100001001111111111110111111100000111010100000011011111111101110111100010001000100010010010001
1000110100101101000100100000000100111011100010110111010000010010000100010100010001000100010010010001
1110100001101001000000001000100100100000111110100001010010010010000100010111110111101100010000110001
1000000100001011000100101111110101100100100000101111110111010111101101110100010000000001000110011011
1111011111111001111110111001000100100100001100000100010010000010000100000000010001000100010000000001
1001000101001001001010001001010000111101100000100100011111111111011111011101111011111111111101111111
1001000101001101000010001000010100100000100000100000010010010010000100000100010001000000100000001001
1000010100000001011110111111010110111111111101111111110000010010010100100101110001000100100010001001
1001000001001001000010001000010100100100100000000100010111110010010100000100000001000000110111101011
1011111111111011110000011111011111100100100010010100010000011000011111111101111111111011100010000001
1000010001001001000010001001000010100000000011011110110010000010000100000000000001000000111111111101
1001010001001011101111111000010010110111101000010100010010010010010111111111111011001010000101001001
1001000111101001000000001001010000100100000010000110111011111111111100001000100001011111100001000001
1111010001001001111110111011111110100100101011010100010010010000000100101010100001000000110111001001
1000010001011011000000001000010000100100101010010100010000010001000110100010001101001000100001101111
1011110111001001111111011111111111111110111111111100010010011101111100001010100101011000100001000101
1001010001101101000100000100000100100100010001000111010111110000000100101010100001001011111011000001
1000010000001001000001000100100100100001010001000100010010010010100100101010110111001000100000000101
1101111111001001000101010000100110111011011011011110110000000111110110111111100001111111111011111111
1001000001011101110111000101111100100001010001000100011011110010100100000000100101000000000000100101
1000001001001001000001000100000101111011000001000100010000010000100101111111101111000100100100100001
1110111111111001001001110100010000100010010100001101000010011110111100101000100101011110100000100101
1000000000001000001001000100010100100000010001000000010010000000000100000000100001000100111110111101
1111111111111111111111111111111111111111111111111111111111101111111111111111111111000100100100100001
1001000101000001001001000000000000000100000000010010010010000010010000000100101001000100000000111101
1000000000000100001001001001000100100100101001010010010010010000010010000100001001101111011110000001
1101111011000101000001101101011110101100101001010110111011011110111111011110100001000100000010110111
1001000001111111101111001001000000100111111101110010000010010010000010000100001001000100000000100001
1001000101000000000001111111111011111100100000010011101000010000010000010101111111111111011111111111
1101011101001001000101001000100000100100100010010110000010011101110000010100000101001001000100010001
1001000001111111101111001000100010000101101000010011011111110000011101111100010001001001000100010001
1111101111001001000101001110000000100100100010110010001010010111110000000110110101001001000100000001
1000000001000001000001101000111101111100000010000010000010010000010010100100010101100001011101111111
1001010001001000011101000010100100100110101111110110111010110001010000100111110111001001000100010001
1000000111101011000101001000100100100100100000010010000000011111011111110000000001001001000100000001
1110110001001001011101101111100100100111111111111011110111110000000000000100100001101001101101111101
1000010001001000000101000000110110001100000000100010010010011111101111111111111111001101000000010001
1001010001111110111111111101100000000100101000000010000010010001000010000001000101001001000111011111
1111011111001000101001000000111111011100101000000011111000010000001010010000000101011001011100010001
1000000001001000001001001010100100000111111111011000010011011101001010111011101101001011000100000001
1111101111000000101001000010100000010100000000000010000010010001111010010001000101001000011111111011
100000C001111101111101110000111111011100010001010010010010010001000000010001000001101001000101001001
1001010001000001000001000010100000000110111111111111110111010111111111111111111111001001000000000001
1011110001000001001101111110111111111100000000000010000010010010100100000000010001001111111111110111
1000010111111011001001000100010010010111111111111111111110110010100001000100010001101000000000000001
1001010001000001101001000100000010000100010000010100100100010000100101101100010001001000100100100001
1001000001000000001000000100010010000100000001000100000100011101111101000110111011111111111111111011
1111110111110111111111011110111000101110111111111100000001010000100001011100010001001000100101000001
1000000001000000000001000100100010000100100010100111011111110010000111000111010001001000100101000101
1111111101001000001001000100000010000000000010100100001001010000100001000100010001001010000000011101
1001000001100010111011000100100011010100100010100100001000011011100101011110111101000000101111000101
1000010001001000001001110111101110010111101110000100101111010000100101000100010001001000100001000001
1001010001101000001101000100001011110100000010100101111001011111101111111111110001111111111111101111
1011111111001001001001110100100010000100101000100000101000010010000100100000010001001001010000001001
1000010101011111111111000101111111111100001010100100001011110010010100000000011011000001010010000001
1001010001000001000101000000000000000111011111110110111000010011011100111011110001001000010010111011
1011000101000101000101111011111111111100000000100100101110111010000000100010010001011111000010001001
1000010101011111000001000000001000000100000010100100000000010010000100100010011011001000010011011111
1111010101000000011011000000100001000111011111111111110111111011101100110110000001001001010010010001
1000010101001000000001000100101001000100000000000100000000010000000100100000010001000001011010000001
1111111111111110111111111111111111111111111111111111111111111111111111111111111111101101010010111111
10000001010010000101001001001010000010001000100100100100000100100010010010010000010010010000101P1101
1001000101000001010100100000101001001000100010000010000100000010001000000000001001111111101110000101
1101101101101101010110000100001111011110110111011111110111111011101011111001000001000000001010000101
1001000001001001010100110111101001001000100010000010010100100010001000001111110111001001000011100001
1011111111011111010100100000001000001011100010010010010100100010001001001001010101111111111010000101
1001010001000100010111111011111110111000101110010010000100000000011111011000010101001000001011110111
1000000001000001000000100000001000001110100011111011101110111110001000001101010001000001001010000001
1101011101110111111100100000101000101000101110000010000100101010001011111001000001001001000010010101
1001000001000100010100001110111000101100000000001010111100000011000001001111111011111111111111011111
1111101100000000010100100100000011101000100010000000000100101010001001001000100001001000101000000101
1000000001000111010111111110111000001110110111110111011111111111111000001000100001001000101000100101
1110111111011100000100010100101111011000100010000010000010010010001111101110100001011000001011101101
1000000101000100010100000100001001001000101110010010010010000000001000001000111011000001100000100001
1001000101111101111110110001011001001110100011110110010000110010001000101000100001001000001000000001
1101011101000000100100000100001100001000111010000010110010010111011011101010000001111111111111111011
1000000001001000000100010100101001000000100010000010010010010010001000101000100101000000000000000001
1111111111111111111111111111111111111111111111111111111111111111111111111111111111111111111111111111