1111111111111111111111111111111111111111111111111111111111111111111111111111111111111111111111111111
10010001000000001000100100100100000000000100100000010010000010000010010010P0000000100100010000100101
10000001000100101000000100100100010001000100000100000010010010010010010010010010001000000000101000C1
10111101101111101000100110110100011101011111101111011010010011010000010000010000001C0110111110100101
100100010001001011101011001C011011000100010000010001001111011001110100C11111110111110100010000101111
1011100000010010000010010010000001000110110001011101111000001001000001001001000010100100011101100101
1001000100010000100010011000111111011100010000010000000000101001000001001001001010100100010000100101
1111111111111111111111010010000001000100011111111101111111111111110111001001011010101111111111110101
1001010010010010000001011110111111111111110010101000100000101000000001100000001010100000000100100001
10000100100100000100010100000C0010100100010000001000000010001011111111000001000010000100010100101111
1101000000110010010100010001001010000100011011101000100010101001000101110111111110100100010000100101
1000010010011111010001011000000000100000010000101110111011101001000001000000001010111101111111100001
1011111111110000011111010001110110111110111011111000100010101011111011000101000010100101000100111011
1001010010010001010000011101000010100100010010001000100000101000001001000101011110100001000100100001
1000010000011101110001010001001010100000010000001111101111111001001001101111000010100001011101100101
1101110111110000011111010111111110111011110110111000000010001011100001000001001000111000000000000111
1000010000010010010C01010000000010100000010010000001010010001001001001111011111111100001000000100001
1001010001010010010001011111011111100010010111111001010110111111101111000000001000111111111011100101
1101000111011011110100010010000000100010010000001111010000001000001001001010001000100010010010110101
1001010001000000010001010010001000101111110C10101000010010001000101001001010000000100010010000100101
1111111111111111111011110000001000100000011011101111011111111101111011011111111111100010010010111101
1000001000010010001001011111111111111111010010101000000000001001000001001010000010111010000011100101
1001000010010010000001010001000001000001010000101000100100101001001001000010010010100010010010100001
1111011110010110111011010001000101001000011111101101101110101000001001001000010000100000000000100101
1001010010110000001000010111101100011101110000001000100100101111111111111111111111111111101111111111
1000000010011111111110110000000101001000000011111111111111111001000100100100010001000100100000010001
1001010010110010010000011111111101111111110000000101000100001001000100100001010001000100100100010001
1011111010010000010001C10010001000100101010001000101000000101001100000111011010111000100110101110001
100101C010010010000001010010001000100001011101101101011101101011000100100001010001011110100100011011
1000010010011110111111111010001000001111010001000001000000101000011101111111010001000100000111110001
1111110111110000000100010011011110100101010001000101111011101001000000100000000001000100100000011101
10001000000100000C000000011000000010C101011101110111000000101001000000111110110100010000111110110001
100010001001011111110001000000100010000001000100000000010C101111111010000000010001000100100CC0000001
1011110110010001000101111111111111111111111111111111110111111000100010111111111111111111111011111111
100000001101000000010001001000010100000100100100001000001C00100000C000100100100100010000001000100101
1000100010010001110100010010010001001000001000001010010010001101111111100100100100010010000000100001
1111101110000101000101111011011100001001000001111010010000001000100010100100000100010010001000100101
1000000010010001000100010000010101011111001101000011110111111000100000100001111110110110111011101111
111111111111111110111111001000010100010100100100101001010010110111101110010000010000000C001000100001
100000000000000010100101101111111100000100100100101000010000100010C000100100100111111101111000100101
1000100100010010101000010010100101000101111011111111110100001000100010100000100100100000001000110101
1111110110111010001110110000000001110111001000000010010001011110000111111011111100000010001011100101
1001000100010000101000010010100101000001001000100010000100001000100000100001000110111111011000101111
1001000111010111101110111110111111000101000000101110010100001000100000100100010000010000001101100001
1001110100010000100000010010000001011101001011100000111111111111111011100101010100010010001000110111
1100000100010010101001010010001001000101001000000010010010101000000000111101110100011011101101100001
1001000100010010101001010010001011111111111111011110010010101111101111100100010111010010001000100101
1111111111011111111111111000011001000101001010000010000000001001001010100100010100010010001000001101
100010100C00100001000001001C001011000101000010010011101111111000001000100000010100000010001110100001
1000001000101001010001011111101001100001001010010010000010001001100010111110111111111111111000111011
1111011101111000011111010000001001000101101111011110010000001011001010100000100100010001001000100001
1001000000000010000000010001001001111101001010001010000010111001111010100100000001010001001101100001
1000001000101000010001011111111011000001000010001011101110001001000010100100100101000000001000100101
111111111111110111111111000000000100010101100000001C000010001111111111111111111111110111111111111111
1001010010100000000000011111111101000001001010111110010010001000000100100000100000100101000010010001
1001010010101001010100010001000101111000011010001010111011101001010100101000100100100101001000010001
1000000000001001010100010000C00001000001000010000010000010001011111110101101111110001101111111010001
1111111111111111111111111011111111111111111111111111111111111001000100001000100010100001000101011011
1000100100100100101000100000000000001000101001000001000010001001000001101011100010101111000100000001
100010010000010010100000E100010010001000000000000101001010001001000100001000111000100100000001010001
1000100000101100001111101111010111011111101111111111011010111011110110111000000010100001000101010001
110110010010C001011000100100010010001001001001001001001010001000000100101000111111111011110111111011
1000101111111100000000100100011010111000001000000000011010001111110100101110100000101001000000010001
1000100100100101111110000111010010001110111001011011000010111000000100001000100100101001001001010001
1000100100100100101000100100011011111000101011001001001010001011111111111000110110001101000011011011
1110100000101100101101111100010010001000101001111011101110001000000000001000100010101001001000010001
100010111000010000100000010001001000100000100100100100001000111111111111111010001C101001001001010001
1000000000100110111001000101110000001011100001000001001011100001010001000010100000101011011011110111
1000100010100100101001011100011111011000101111011111001010001000000001000000111111100001001000010001
1110111111111100001101000100010010001000001001010101101111011110111011110110100000001001111101111101
1000100000000100101001000110110000001000101001010001001010001000010001000010111111101111000000010001
1000000010010110111101111100010110001101111000000101000010001001011011111011100000000001001000010001
1011111011011100101000000000110011000000001011110101011010111011110000001000111111110111111111111111
1000100010000100001001010100010010001001001000010101001000001000010001000010100000100000010000001001
1111111111111111111111111111111111111111111111011111111111111101111111111111100100100100010001001001
1000100010001000100010010000000100101010010010010000010100001001000000000100110100100100011011011011
10000000100010001000100000000101000000100100000100010101001010010001010001001001100C0111010001001001
1111110111101000000011111011111101111011010010010111010101111000010101110101101100100100011111100011
1001000010001011110110001001000100001010011011110001C00000001011000101000100100100101111110001001001
1000001010001000100010000000010111111011010000011111110100101001000101000000100100100000000000001001
1000001011101000100011111111011100100010000001000010000100101111111111111101111111111111111111111111
111011111000001011100000100000010010001011011111000001011110100010C010000100010010000001000001010101
1C001000100010000010100010001001011000000100000100100101000010001000100101000000100010010010000001C1
1000100010111001000011101100000000000110011111110111111101111101100010010000010010001000C01001000101
1010001110001001111010001000100100100010110010010010010100101000111011111101111111111111111111101101
1000000010001101000011000001111111110110010010010010010100101000000010010000001010001000101000000101
11110111110110000010100010010001000000101110100000000001000011111110100100100000100010000010C0000101
100000101000111101111000100101010C100010010000010010010111011000000010000110111110000000101110111101
1001000010111000000000001000010111111110111111111111111100001001000000010010000011101111111000000101
1000001010001111111101111111111100000100100010010000010100101111110110010010010010001000101001000101
1110111110001001001001010001010100010100000010010010010101111000000011110110010010001000001011000101
10000100101110000010C1010000010111010001111010110010000100001000101010010010111111101011111001101101
1000010010001110111000011011010100010100100000011011111101111000001010010010010000001000100000000101
1011111010001000001101110000010100010100110111110010000100001111011011000110010010001000101111011101
1001010010111001001000011110110111111101100010010010010100101000000010010000000011101110001000000101
10010000100010000010C1010000000100000000100000011011110101111001001010111111111110000000101011111101
1000010000001111101101111111110100101000110111110000000100001111011110000000000011111110111000000101
1101111110111000001000010000000111101010100000011111011100101000000010001001010010000000101101111101
1000000010001001000001000010010100001010100100000000000100101000001010001001010010001000001000000001
1111111111111111111111111111111111111111111111111111111111111111111111111111111111111111111111111111