1111111111111111111111111111111111
11E0000000000000100000100000000001
10100101001C0000101001000000010101
1010110010101010001001000000010101
1000110001001000C00000000000000P11
1111111111111111111111111111111111