11111
1ini1
1aaa1
1aaa1
1aaa1
1aaa1
1aaa1
1aaa1
1aaa1
1aaa1
1aaa1
1aaa1
1aaa1
1aCa1
1aPa1
1aEa1
1fin1
11111