111111111
100010C01
10P000101
10C000E01
100000001
111111111
