111111111111111111
1E0000000C000000P1
111111111111111111
